
## Relative clauses: {'agent': 'none'}
## RC roles: {'agent': 'none'}
## Event insertion: {non-event}
## Insertion voice: {None}

sentences0	the assistant does not run
sentences1	the assistants were not running
sentences2	the girl does not run
sentences3	the senator is shouting
sentences4	the secretary was not resigning
sentences5	the girls shouted
sentences6	the students did not shout
sentences7	the judge sleeps
sentences8	the child sleeps
sentences9	the assistants were dancing

## Relative clauses: {'agent': 'transitive'}
## RC roles: {'agent': 'patient'}
## Event insertion: {non-event}
## Insertion voice: {None}

sentences10	the secretary that the women call does not sleep
sentences11	the children that the girls are following were shouting
sentences12	the senator that the judges watched was dancing
sentences13	the secretary that is supported by the assistants resigns
sentences14	the secretaries that the children observe sleep
sentences15	the professors that are liked by the men were shouting
sentences16	the doctor that the women support resigns
sentences17	the child that the secretary liked resigned
sentences18	the assistants that the bankers were believing did not dance
sentences19	the officers that were helped by the senators are not dancing

## Relative clauses: {'agent': 'transitive'}
## RC roles: {'agent': 'agent'}
## Event insertion: {non-event}
## Insertion voice: {None}

sentences20	the woman that was not believing the man does not dance
sentences21	the women that recommended the scientist were not dancing
sentences22	the lawyers that watched the secretaries do not sleep
sentences23	the boy that does not observe the presidents was not sleeping
sentences24	the banker that observes the assistant does not sleep
sentences25	the judge that was believing the girl resigned
sentences26	the professors that were not following the lawyer are dancing
sentences27	the secretaries that are not loving the boys are running
sentences28	the child that is not believing the officer does not run
sentences29	the men that do not love the doctor were running

## Relative clauses: {'agent': 'intransitive'}
## RC roles: {'agent': 'agent'}
## Event insertion: {non-event}
## Insertion voice: {None}

sentences30	the women that danced slept
sentences31	the lawyers that resigned were running
sentences32	the secretary that danced was sleeping
sentences33	the secretaries that ran were dancing
sentences34	the boys that ran resigned
sentences35	the officer that dances shouts
sentences36	the boy that does not shout is not running
sentences37	the senators that were sleeping are not shouting
sentences38	the officer that did not shout was dancing
sentences39	the girls that resign do not run

## Relative clauses: {'agent': 'none', 'patient': 'none'}
## RC roles: {'agent': 'none', 'patient': 'none'}
## Event insertion: {non-event}
## Insertion voice: {None}

sentences40	the bankers do not believe the men
sentences41	the students are not hated by the professors
sentences42	the assistant is helped by the children
sentences43	the girls are liked by the president
sentences44	the president was not advised by the doctor
sentences45	the man was loved by the boys
sentences46	the doctors watch the secretary
sentences47	the officer is advising the men
sentences48	the doctor is contacted by the banker
sentences49	the banker is not being followed by the scientist

## Relative clauses: {'agent': 'none', 'patient': 'transitive'}
## RC roles: {'agent': 'none', 'patient': 'patient'}
## Event insertion: {non-event}
## Insertion voice: {None}

sentences50	the boy is contacting the women that the child followed
sentences51	the banker that the professors called is not being supported by the women
sentences52	the lawyers that were hit by the assistants are not being supported by the senator
sentences53	the lawyer does not love the assistant that is being hit by the scientists
sentences54	the women that are believed by the president are being advised by the lawyer
sentences55	the presidents supported the lawyers that were recommended by the judge
sentences56	the judges that were hit by the children were not being hated by the girls
sentences57	the professors do not contact the senators that the girl followed
sentences58	the president does not advise the women that the scientists were avoiding
sentences59	the judge was helping the assistant that was supported by the girls

## Relative clauses: {'agent': 'none', 'patient': 'transitive'}
## RC roles: {'agent': 'none', 'patient': 'agent'}
## Event insertion: {non-event}
## Insertion voice: {None}

sentences60	the doctors that advised the judges are not contacted by the scientist
sentences61	the secretary was following the boy that was supporting the doctor
sentences62	the officers avoid the senators that supported the presidents
sentences63	the senator was hitting the lawyer that does not love the scientist
sentences64	the girl that supports the woman is not avoided by the child
sentences65	the women that were not believing the president are watched by the officers
sentences66	the assistants that avoided the judges are not being observed by the professors
sentences67	the scientist that was hating the woman was being met by the boy
sentences68	the scientists that are avoiding the bankers are being loved by the officer
sentences69	the banker hates the girl that believes the doctors

## Relative clauses: {'agent': 'none', 'patient': 'intransitive'}
## RC roles: {'agent': 'none', 'patient': 'agent'}
## Event insertion: {non-event}
## Insertion voice: {None}

sentences70	the assistants that shout were being liked by the presidents
sentences71	the doctor that runs was observed by the professors
sentences72	the banker that runs is helped by the child
sentences73	the child that runs was hit by the professors
sentences74	the men believe the boys that shout
sentences75	the doctors that resign were not being supported by the judge
sentences76	the lawyer was following the judge that slept
sentences77	the doctor that resigns is being avoided by the boy
sentences78	the boy that did not shout is helped by the assistants
sentences79	the senator that slept is loved by the lawyers

## Relative clauses: {'agent': 'transitive', 'patient': 'none'}
## RC roles: {'agent': 'patient', 'patient': 'none'}
## Event insertion: {non-event}
## Insertion voice: {None}

sentences80	the child that the officer watched was not observing the girls
sentences81	the girl is not being recommended by the senator that the lawyer observed
sentences82	the child is not being avoided by the lawyer that the secretary does not contact
sentences83	the boy that the scientists avoid was not believing the secretaries
sentences84	the boys that are called by the professors are not advising the students
sentences85	the banker that is watched by the secretary is hitting the officers
sentences86	the bankers that the men watched hate the lawyer
sentences87	the boys are not being advised by the scientists that the professors believed
sentences88	the presidents that the boy recommends avoided the professor
sentences89	the girls were not being advised by the banker that the boys observe

## Relative clauses: {'agent': 'transitive', 'patient': 'none'}
## RC roles: {'agent': 'agent', 'patient': 'none'}
## Event insertion: {non-event}
## Insertion voice: {None}

sentences90	the officer is being avoided by the doctors that believed the men
sentences91	the women that are contacting the officer do not hit the secretaries
sentences92	the banker that was contacting the child was not hating the doctors
sentences93	the lawyer that avoided the president is contacting the boy
sentences94	the doctor that loved the bankers is not watching the boy
sentences95	the lawyers that avoid the president hit the banker
sentences96	the doctor that loved the officers observed the assistants
sentences97	the woman is observed by the girls that followed the doctor
sentences98	the secretaries that avoided the professor advised the lawyer
sentences99	the president that did not recommend the students calls the doctors

## Relative clauses: {'agent': 'intransitive', 'patient': 'none'}
## RC roles: {'agent': 'agent', 'patient': 'none'}
## Event insertion: {non-event}
## Insertion voice: {None}

sentences100	the students that were running did not call the president
sentences101	the professor that does not resign was not calling the children
sentences102	the judge that ran was loving the assistants
sentences103	the assistants that did not run do not hate the officer
sentences104	the scientists are not observed by the professors that dance
sentences105	the senator that sleeps was believing the boy
sentences106	the girl was not being watched by the child that runs
sentences107	the bankers that were dancing were not advising the doctors
sentences108	the banker was not helped by the lawyer that does not resign
sentences109	the girls were not being liked by the officer that was not shouting

Number of sentences: 110
